##############
#............#          ######
#............############....#
#............'..........+....#
#....~~......############....#
#.....~~.....#          #....#
#......~~....#          #.>..#
##############          ######
